*..*.+....
..*..*....
*....*....
..***..+..
.....**.**
S..+.*....
.....***..
******....
..E.*..+..
......**..