....####..
...##..#..
.###...#..
.#.....#..
.###...#..
####...##.
........#.
......###.
..#..##...
..####....