.**..+..***
.S..+.*...*
.***..*..+.
.**..**..*.
*.+...**...
..*******..
*....*.+...
..**....*..
*...+...*..
*...*.....+
.**.+..*.E.